000004000000044400
040400044044004440
040004044044040440
000404040000000040
440400000404404000
040004440404004040
000440400000044000
040000440404000040
044440000040044440
004440444000000000
400444004440444400
440000400040004440
000440404040404440
040000004044400040
000400444000004000
040400040044044404
000444000444044444
040000040000000000