000000000000000000
005050005500000550
005005000505500500
005000055505000500
005555050000050005
000500000550555000
000000550000050000
000050000500000000
005550555500500500
000500500005500550
000000055000500000
055555005050000055
000005500055005000
055500005000005050
000500055005555000
000555050000050000
005500055000550550
000000000050000500