000000000000000000
500000000000000500
000555550500050000
055500055550050055
050005005000555000
055500000000500000
000550555000005500
000500005500050050
005505000000000050
500000055005500000
555000550000550055
500000500550500000
000055500000005005
000050005555005505
005055000005555000
055005000500005550
000005000000500500
005500005500550000