000000000000000333
030303003333030030
030303300330033000
000303330033030030
030003000330000330
000300030000303330
330303033300000330
000000000003300000
030330333300000333
033330333303303300
000330303303303003
030000003300003000
033033300000000300
030003003330003003
000300030000300003
030003330000033300
000300000300000000
030003330003303030