000000040000000000
004444000404040400
000044000000000004
040000404400044440
004000044440000000
000404040404040400
044400000400000000
044400404400000000
000000400000000000
040044444444444400
000440000000000440
040000000400000000
000000000400000000
040404040404040400
000000000400000000
040000000400000000
004040404040404040
000444040400000000