000033000000000000
030303030300300030
030000030303030330
000303030000000000
030300030033303000
330003030333003000
330300000033033330
000003003000000000
030300333003303330
030330000000000000
000033003000330000
033300303030003030
000330003030303300
030000003033000003
030303300000033303
030000000033000303
000003303330033303
033300000000000000